......#...^..................v...#...#......#.v..
....>...>......#<..........S....^..^...#..G...^..
....#..#...#....><...........#...##...#.......#.#
...#......>..........<...#.>.##........#......#..
#<..#...#.>.......>.<.........^.#...#.......^....
.<.......#.............#..#.....^#..^#...........